=MainServlet
main=MainServlet
login=LoginServlet
google-signin=GoogleSigninServlet
logout=LogoutServlet
register=RegisterServlet
search=MainSearchServlet
search-all-cars=SearchAllCarsServlet
search-by-name=SearchByNameServlet
search-by-category-and-rental-date=SearchByCategoryAndRentalDateServlet
activation=ActivationServlet
lease=LeaseServlet
show-cart=ShowCartServlet
action-in-cart=ActionInCartServlet
confirm=ConfirmServlet
checkout=CheckoutServlet
discount=DiscountServlet
show-history=ShowHistoryServlet
search-history=SearchHistoryServlet
search-by-order-date=SearchByOrderDateServlet
view-details=ViewDetailServlet
delete-order=DeleteOrderServlet
cart=cart.jsp
feedback=feedback.jsp
show-feed-back-page=ShowFeedbackPageServlet
rating=RatingServlet
login-page=login.jsp
register-page=register.jsp
main-page=main.jsp
activatation-page=activation.jsp
activated=activation-sucess.html